i accfonts: Utilities to derive new fonts from existing ones
i accfonts.universal-darwin: universal-darwin files of accfonts
i ae: Virtual fonts for T1 encoded CMR-fonts
i afm2pl: convert AFM to TeX property list (.pl) metrics
i afm2pl.universal-darwin: universal-darwin files of afm2pl
i albatross: Find fonts that contain a given glyph
i albatross.universal-darwin: universal-darwin files of albatross
i algorithms: A suite of tools for typesetting algorithms in pseudo-code
i amscls: AMS document classes for LaTeX
i amsfonts: TeX fonts from the American Mathematical Society
i amsmath: AMS mathematical facilities for LaTeX
i anysize: A simple package to set up document margins
i appendix: Extra control of appendices
i arabxetex: An ArabTeX-like interface for XeLaTeX
i arydshln: Draw dash-lines in array/tabular
i atbegshi: Execute stuff at \shipout time
i attachfile2: Attach files into PDF
i attachfile2.universal-darwin: universal-darwin files of attachfile2
i atveryend: Hooks at the very end of a document
i automata: Finite state machines, graphs and trees in MetaPost
i auxhook: Hooks for auxiliary files
i avantgar: URW 'Base 35' font pack for LaTeX
i babel: Multilingual support for LaTeX, LuaLaTeX, XeLaTeX, and Plain TeX
i babel-basque: Babel contributed support for Basque
i babel-czech: Babel support for Czech
i babel-danish: Babel contributed support for Danish
i babel-dutch: Babel contributed support for Dutch
i babel-english: Babel support for English
i babel-finnish: Babel support for Finnish
i babel-french: Babel contributed support for French
i babel-german: Babel support for documents written in German
i babel-hungarian: Babel support for Hungarian (Magyar)
i babel-italian: Babel support for Italian text
i babel-norsk: Babel support for Norwegian
i babel-polish: Babel support for Polish
i babel-portuges: Babel support for Portuges
i babel-spanish: Babel support for Spanish
i babel-swedish: Babel support for typesetting Swedish
i babelbib: Multilingual bibliographies
i bbcard: Bullshit bingo, calendar and baseball-score cards
i beamer: A LaTeX class for producing presentations and slides
i bibtex: Process bibliographies (bib files) for LaTeX or other formats
i bibtex.universal-darwin: universal-darwin files of bibtex
i bidi-atbegshi: Bidi-aware shipout macros
i bidicontour: Bidi-aware coloured contour around text
i bidipagegrid: Bidi-aware page grid in background
i bidipresentation: Experimental bidi presentation
i bidishadowtext: Bidi-aware shadow text
i bigintcalc: Integer calculations on very large numbers
i bitset: Handle bit-vector datatype
i blockdraw_mp: Block diagrams and bond graphs, with MetaPost
i bookman: URW 'Base 35' font pack for LaTeX
i bookmark: A new bookmark (outline) organization for hyperref
i booktabs: Publication quality tables in LaTeX
i bpolynomial: Drawing polynomial functions of up to order 3
i breqn: Automatic line breaking of displayed equations
i businesscard-qrcode: Business cards with QR-Code
i caption: Customising captions in floating environments
i carlisle: David Carlisle's small packages
i changepage: Margin adjustment and detection of odd/even pages
i charter: Charter fonts
i cite: Improved citation handling in LaTeX
i cleveref: Intelligent cross-referencing
i cm: Computer Modern fonts
i cm-super: CM-Super family of fonts
i cmap: Make PDF files searchable and copyable
i cmarrows: MetaPost arrows and braces in the Computer Modern style
i cmextra: Knuth's local information
i collection-basic: Essential programs and files
i collection-fontsrecommended: Recommended fonts
i collection-fontutils: Graphics and font utilities
i collection-latex: LaTeX fundamental packages
i collection-latexrecommended: LaTeX recommended packages
i collection-metapost: MetaPost and Metafont packages
i collection-xetex: XeTeX and packages
i colorprofiles: Collection of free ICC profiles
i colortbl: Add colour to LaTeX tables
i comment: Selectively include/exclude portions of text
i courier: URW 'Base 35' font pack for LaTeX
i cqubeamer: LaTeX Beamer Template for Chongqing University
i crop: Support for cropmarks
i ctable: Flexible typesetting of table and figure floats using key/value directives
i ctablestack: Catcode table stable support
i dehyph: German hyphenation patterns for traditional orthography
i dosepsbin: Deal with DOS binary EPS files
i dosepsbin.universal-darwin: universal-darwin files of dosepsbin
i drv: Derivation trees with MetaPost
i dviincl: Include a DVI page into MetaPost output
i dvipdfmx: An extended version of dvipdfm
i dvipdfmx.universal-darwin: universal-darwin files of dvipdfmx
i dvips: A DVI to PostScript driver
i dvips.universal-darwin: universal-darwin files of dvips
i dvipsconfig: Collection of dvips PostScript headers
i ec: Computer modern fonts in T1 and TS1 encodings
i els-cas-templates: Elsevier updated LaTeX templates
i elsarticle: Class for articles for submission to Elsevier journals
i emp: "Encapsulate" MetaPost figures in a document
i enctex: A TeX extension that translates input on its way into TeX
i enotez: Support for end-notes
i enumitem: Control layout of itemize, enumerate, description
i epsincl: Include EPS in MetaPost figures
i epstopdf: Convert EPS to PDF using Ghostscript
i epstopdf-pkg: Call epstopdf "on the fly"
i epstopdf.universal-darwin: universal-darwin files of epstopdf
i eso-pic: Add picture commands (or backgrounds) to every page
i etaremune: Reverse-counting enumerate environment
i etex: An extended version of TeX, from the NTS project
i etex-pkg: E-TeX support package
i etexcmds: Avoid name clashes with e-TeX commands
i etoolbox: e-TeX tools for LaTeX
i euenc: Unicode font encoding definitions for XeTeX
i euler: Use AMS Euler fonts for math
i euro: Provide Euro values for national currency amounts
i euro-ce: Euro and CE sign font
i eurosym: Metafont and macros for Euro sign
i everysel: Provides hooks into \selectfont
i everyshi: Take action at every \shipout
i expressg: Diagrams consisting of boxes, lines, and annotations
i exteps: Include EPS figures in MetaPost
i extsizes: Extend the standard classes' size options
i fancybox: Variants of \fbox and other games with boxes
i fancyhdr: Extensive control of page headers and footers in LaTeX2e
i fancyref: A LaTeX package for fancy cross-referencing
i fancyvrb: Sophisticated verbatim text
i featpost: MetaPost macros for 3D
i feynmf: Macros and fonts for creating Feynman (and other) diagrams
i feynmp-auto: Automatic processing of feynmp graphics
i filehook: Hooks for input files
i firstaid: First aid for external LaTeX files and packages that need updating
i fix2col: Fix miscellaneous two column mode features
i fixlatvian: Improve Latvian language support in XeLaTeX
i fiziko: A MetaPost library for physics textbook illustrations
i float: Improved interface for floating objects
i font-change-xetex: Macros to change text and mathematics fonts in plain XeTeX
i fontawesome5: Font Awesome 5 with LaTeX support
i fontaxes: Additional font axes for LaTeX
i fontbook: Generate a font book
i fontinst: Help with installing fonts for TeX and LaTeX
i fontinst.universal-darwin: universal-darwin files of fontinst
i fontools: Tools to simplify using fonts (especially TT/OTF ones)
i fontools.universal-darwin: universal-darwin files of fontools
i fontspec: Advanced font selection in XeLaTeX and LuaLaTeX
i fontware: Tools for virtual font metrics
i fontware.universal-darwin: universal-darwin files of fontware
i fontwrap: Bind fonts to specific unicode blocks
i footnotehyper: hyperref aware footnote.sty
i fp: Fixed point arithmetic
i fpl: SC and OsF fonts for URW Palladio L
i frankenstein: A collection of LaTeX packages
i garrigues: MetaPost macros for the reproduction of Garrigues' Easter nomogram
i geometry: Flexible and complete interface to document dimensions
i gettitlestring: Clean up title references
i glyphlist: Adobe Glyph List and TeX extensions
i gmp: Enable integration between MetaPost pictures and LaTeX
i graphics: The LaTeX standard graphics bundle
i graphics-cfg: Sample configuration files for LaTeX color and graphics
i graphics-def: Colour and graphics option files
i grfext: Manipulate the graphics package's list of extensions
i grffile: Extended file name support for graphics (legacy package)
i hatching: MetaPost macros for hatching interior of closed paths
i helvetic: URW 'Base 35' font pack for LaTeX
i hershey-mp: MetaPost support for the Hershey font file format
i hologo: A collection of logos with bookmark support
i hopatch: Load patches for packages
i huffman: Drawing binary Huffman trees with MetaPost and METAOBJ
i hycolor: Implements colour for packages hyperref and bookmark
i hyperref: Extensive support for hypertext in LaTeX
i hyph-utf8: Hyphenation patterns expressed in UTF-8
i hyphen-base: core hyphenation support files
i hyphen-basque: Basque hyphenation patterns.
i hyphen-czech: Czech hyphenation patterns.
i hyphen-danish: Danish hyphenation patterns.
i hyphen-dutch: Dutch hyphenation patterns.
i hyphen-english: English hyphenation patterns.
i hyphen-finnish: Finnish hyphenation patterns.
i hyphen-french: French hyphenation patterns.
i hyphen-german: German hyphenation patterns.
i hyphen-hungarian: Hungarian hyphenation patterns.
i hyphen-italian: Italian hyphenation patterns.
i hyphen-norwegian: Norwegian Bokmal and Nynorsk hyphenation patterns.
i hyphen-polish: Polish hyphenation patterns.
i hyphen-portuguese: Portuguese hyphenation patterns.
i hyphen-spanish: Spanish hyphenation patterns.
i hyphen-swedish: Swedish hyphenation patterns.
i hyphenex: US English hyphenation exceptions file
i ifplatform: Conditionals to test which platform is being used
i iftex: Am I running under pdfTeX, XeTeX or LuaTeX?
i index: Extended index for LaTeX including multiple indexes
i infwarerr: Complete set of information/warning/error message macros
i intcalc: Expandable arithmetic operations with integers
i interchar: Managing character class schemes in XeTeX
i jknapltx: Miscellaneous packages by Joerg Knappen
i kastrup: Convert numbers into binary, octal and hexadecimal
i knuth-lib: Core TeX and Metafont sources from Knuth
i knuth-local: Knuth's local information
i koma-script: A bundle of versatile classes and packages
i kpathsea: Path searching library for TeX-related files
i kpathsea.universal-darwin: universal-darwin files of kpathsea
i kvdefinekeys: Define keys for use in the kvsetkeys package
i kvoptions: Key value format for package options
i kvsetkeys: Key value parser with default handler support
i l3backend: LaTeX3 backend drivers
i l3experimental: Experimental LaTeX3 concepts
i l3kernel: LaTeX3 programming conventions
i l3packages: High-level LaTeX3 concepts
i lastpage: Reference last page for Page N of M type footers
i latex: A TeX macro package that defines LaTeX
i latex-base-dev: Development pre-release of the LaTeX kernel
i latex-bin: LaTeX executables and man pages
i latex-bin.universal-darwin: universal-darwin files of latex-bin
i latex-firstaid-dev: Development pre-release of the LaTeX firstaid package
i latex-fonts: A collection of fonts used in LaTeX distributions
i latex-lab: LaTeX laboratory
i latexbug: Bug-classification for LaTeX related bugs
i latexconfig: configuration files for LaTeX-related formats
i latexmp: Interface for LaTeX-based typesetting in MetaPost
i lcdftypetools: A bundle of outline font manipulation tools
i lcdftypetools.universal-darwin: universal-darwin files of lcdftypetools
i letltxmacro: Let assignment for LaTeX macros
i lineno: Line numbers on paragraphs
i listings: Typeset source code listings using LaTeX
i lm: Latin modern fonts in outline formats
i lm-math: OpenType maths fonts for Latin Modern
i ltxcmds: Some LaTeX kernel commands for general use
i ltxmisc: Miscellaneous LaTeX packages, etc
i lua-alt-getopt: Process application arguments the same way as getopt_long
i lua-uni-algos: Unicode algorithms for LuaTeX
i luafindfont: Search fonts in the LuaTeX font database
i luafindfont.universal-darwin: universal-darwin files of luafindfont
i luahbtex: LuaTeX with HarfBuzz library for glyph shaping
i luahbtex.universal-darwin: universal-darwin files of luahbtex
i lualibs: Additional Lua functions for LuaTeX macro programmers
i luaotfload: OpenType 'loader' for Plain TeX and LaTeX
i luaotfload.universal-darwin: universal-darwin files of luaotfload
i luatex: The LuaTeX engine
i luatex.universal-darwin: universal-darwin files of luatex
i luatexbase: Basic resource management for LuaTeX code
i lwarp: Converts LaTeX to HTML
i lwarp.universal-darwin: universal-darwin files of lwarp
i makecmds: The new \makecommand command always (re)defines a command
i makeindex: Makeindex development sources
i makeindex.universal-darwin: universal-darwin files of makeindex
i manfnt-font: Knuth's "manual" fonts
i marginfix: Patch \marginpar to avoid overfull margins
i marginnote: Notes in the margin, even where \marginpar fails
i marvosym: Martin Vogel's Symbols (marvosym) font
i mathpazo: Fonts to typeset mathematics to match Palatino
i mathspec: Specify arbitrary fonts for mathematics in XeTeX
i mathtools: Mathematical tools to use with amsmath
i mcf2graph: Draw chemical structure diagrams with MetaPost
i mdwtools: Miscellaneous tools by Mark Wooding
i memoir: Typeset fiction, non-fiction and mathematical books
i metafont: A system for specifying fonts
i metafont.universal-darwin: universal-darwin files of metafont
i metago: MetaPost output of Go positions
i metalogo: Extended TeX logo macros
i metaobj: MetaPost package providing high-level objects
i metaplot: Plot-manipulation macros for use in MetaPost
i metapost: A development of Metafont for creating graphics
i metapost-colorbrewer: An implementation of the colorbrewer2.org colours for MetaPost
i metapost.universal-darwin: universal-darwin files of metapost
i metatype1: Generate Type 1 fonts from MetaPost
i metauml: MetaPost library for typesetting UML diagrams
i mf2pt1: Convert stylized Metafont to PostScript Type 1
i mf2pt1.universal-darwin: universal-darwin files of mf2pt1
i mflogo: LaTeX support for Metafont logo fonts
i mflogo-font: Metafont logo font
i mfnfss: Packages to typeset oldgerman and pandora fonts in LaTeX
i mfpic: Draw Metafont/post pictures from (La)TeX commands
i mfpic4ode: Macros to draw direction fields and solutions of ODEs
i mfware: Supporting tools for use with Metafont
i mfware.universal-darwin: universal-darwin files of mfware
i microtype: Subliminal refinements towards typographical perfection
i minim-hatching: Create tiling patterns with the minim-mp MetaPost processor
i moderncv: A modern curriculum vitae class
i modes: A collection of Metafont mode_def's
i moreverb: Extended verbatim
i mp3d: 3D animations
i mparrows: MetaPost module with different types of arrow heads
i mpattern: Patterns in MetaPost
i mpchess: Drawing chess boards and positions with MetaPost
i mpcolornames: Extend list of predefined colour names for MetaPost
i mpgraphics: Process and display MetaPost figures inline
i mptopdf: mpost to PDF, native MetaPost graphics inclusion
i mptopdf.universal-darwin: universal-darwin files of mptopdf
i mptrees: Probability trees with MetaPost
i ms: Various LaTeX packages by Martin Schroder
i multirow: Create tabular cells spanning multiple rows
i na-position: Tables of relative positions of curves and asymptotes or tangents in Arabic documents
i natbib: Flexible bibliography support
i ncntrsbk: URW 'Base 35' font pack for LaTeX
i newfloat: Define new floating environments
i newtx: Alternative uses of the TX fonts, with improved metrics
i ntgclass: "European" versions of standard classes
i oberdiek: A bundle of packages submitted by Heiko Oberdiek
i pagesel: Select pages of a document for output
i palatino: URW 'Base 35' font pack for LaTeX
i parskip: Layout with zero \parindent, non-zero \parskip
i pbox: A variable-width \parbox command
i pdfcolfoot: Separate color stack for footnotes with pdfTeX
i pdfescape: Implements pdfTeX's escape features using TeX or e-TeX
i pdflscape: Make landscape pages display as landscape
i pdfmanagement-testphase: LaTeX PDF management testphase bundle
i pdfpages: Include PDF documents in LaTeX
i pdftex: A TeX extension for direct creation of PDF
i pdftex.universal-darwin: universal-darwin files of pdftex
i pdftexcmds: LuaTeX support for pdfTeX utility functions
i pgf: Create PostScript and PDF graphics in TeX
i philokalia: A font to typeset the Philokalia Books
i piechartmp: Draw pie-charts using MetaPost
i plain: The Plain TeX format
i polyglossia: An alternative to babel for XeLaTeX and LuaLaTeX
i ps2eps: Produce Encapsulated PostScript from PostScript
i ps2eps.universal-darwin: universal-darwin files of ps2eps
i ps2pk: Generate a PK font from an Adobe Type 1 font
i ps2pk.universal-darwin: universal-darwin files of ps2pk
i psfrag: Replace strings in encapsulated PostScript figures
i pslatex: Use PostScript fonts by default
i psnfss: Font support for common PostScript fonts
i pspicture: PostScript picture support
i psutils: PostScript utilities
i psutils.universal-darwin: universal-darwin files of psutils
i ptext: A 'lipsum' for Persian
i pxfonts: Palatino-like fonts in support of mathematics
i ragged2e: Alternative versions of "ragged"-type commands
i rcs: Use RCS (revision control system) tags in LaTeX documents
i realscripts: Access OpenType subscript and superscript glyphs
i refcount: Counter operations with label references
i regexpatch: High level patching of commands
i repere: MetaPost macros for secondary school mathematics teachers
i rerunfilecheck: Checksum based rerun checks on auxiliary files
i revtex: Styles for various Physics Journals
i roex: Metafont-PostScript conversions
i roundrect: MetaPost macros for highly configurable rounded rectangles (optionally with text)
i rsfs: Ralph Smith's Formal Script font
i sansmath: Maths in a sans font
i scheme-basic: basic scheme (plain and latex)
i scheme-infraonly: infrastructure-only scheme (no TeX at all)
i scheme-minimal: minimal scheme (plain only)
i scheme-small: small scheme (basic + xetex, metapost, a few languages)
i section: Modifying section commands in LaTeX
i seminar: Make overhead slides
i sepnum: Print numbers in a "friendly" format
i seqsplit: Split long sequences of characters in a neutral way
i setspace: Set space between lines
i shapes: Draw polygons, reentrant stars, and fractions in circles with MetaPost
i simple-resume-cv: Template for a simple resume or curriculum vitae (CV), in XeLaTeX
i simple-thesis-dissertation: Template for a simple thesis or dissertation (Ph.D. or master's degree) or technical report, in XeLaTeX
i slideshow: Generate slideshow with MetaPost
i soul: Hyphenation for letterspacing, underlining, and more
i splines: MetaPost macros for drawing cubic spline interpolants
i stringenc: Converting a string between different encodings
i suanpan: MetaPost macros for drawing Chinese and Japanese abaci
i subfig: Figures broken into subfigures
i supertabular: A multi-page tables package
i symbol: URW 'Base 35' font pack for LaTeX
i synctex: engine-level feature synchronizing output and source
i synctex.universal-darwin: universal-darwin files of synctex
i t1utils: Simple Type 1 font manipulation programs
i t1utils.universal-darwin: universal-darwin files of t1utils
i tabto-ltx: "Tab" to a measured position in the line
i tetragonos: Four-Corner codes of Chinese characters
i tex: A sophisticated typesetting engine
i tex-gyre: TeX Fonts extending freely available URW fonts
i tex-gyre-math: Maths fonts to match tex-gyre text fonts
i tex-ini-files: Model TeX format creation files
i tex.universal-darwin: universal-darwin files of tex
i texlive-common: TeX Live documentation (common elements)
i texlive-en: TeX Live manual (English)
i texlive-msg-translations: translations of the TeX Live installer and TeX Live Manager
i texlive-scripts: TeX Live infrastructure programs
i texlive-scripts.universal-darwin: universal-darwin files of texlive-scripts
i texlive.infra: basic TeX Live infrastructure
i texlive.infra.universal-darwin: universal-darwin files of texlive.infra
i textcase: Case conversion ignoring mathematics, etc
i textpath: Setting text along a path with MetaPost
i threeddice: Create images of dice with one, two, or three faces showing, using MetaPost
i thumbpdf: Thumbnails for pdfTeX and dvips/ps2pdf
i thumbpdf.universal-darwin: universal-darwin files of thumbpdf
i times: URW 'Base 35' font pack for LaTeX
i tipa: Fonts and macros for IPA phonetics characters
i titlesec: Select alternative section titles
i tlshell: GUI frontend (tcl/tk-based) for tlmgr
i tlshell.universal-darwin: universal-darwin files of tlshell
i tocloft: Control table of contents, figures, etc
i tools: The LaTeX standard tools bundle
i totcount: Find the last value of a counter
i translations: Internationalisation of LaTeX2e packages
i translator: Easy translation of strings in LaTeX
i ttfutils: convert TrueType to TFM and PK fonts
i ttfutils.universal-darwin: universal-darwin files of ttfutils
i txfonts: Times-like fonts in support of mathematics
i typehtml: Typeset HTML directly from LaTeX
i ucharcat: Implementation of the (new in 2015) XeTeX \Ucharcat command in lua, for LuaTeX
i ucharclasses: Font actions in XeTeX according to what is being processed
i ulem: Package for underlining
i underscore: Control the behaviour of "_" in text
i unicode-bidi: Experimental unicode bidi package for XeTeX
i unicode-data: Unicode data and loaders for TeX
i unicode-math: Unicode mathematics support for XeTeX and LuaTeX
i unimath-plain-xetex: OpenType math support in (plain) XeTeX
i uniquecounter: Provides unlimited unique counter
i unisugar: Define syntactic sugar for Unicode LaTeX
i upquote: Show "realistic" quotes in verbatim
i url: Verbatim with URL-sensitive line breaks
i utopia: Adobe Utopia fonts
i was: A collection of small packages by Walter Schmidt
i wasy: The wasy fonts (Waldi symbol fonts)
i wasy-type1: Type 1 versions of wasy fonts
i wasysym: LaTeX support for the wasy fonts
i xcolor: Driver-independent color extensions for LaTeX and pdfLaTeX
i xdvi: A DVI previewer for the X Window System
i xdvi.universal-darwin: universal-darwin files of xdvi
i xebaposter: Create beautiful scientific Persian/Latin posters using TikZ
i xechangebar: An extension of package changebar that can be used with XeLaTeX
i xecolor: Support for color in XeLaTeX
i xecyr: Using Cyrillic languages in XeTeX
i xeindex: Automatic index generation for XeLaTeX
i xelatex-dev: (shortdesc missing)
i xelatex-dev.universal-darwin: universal-darwin files of xelatex-dev
i xesearch: A string finder for XeTeX
i xespotcolor: Spot colours support for XeLaTeX
i xetex: An extended variant of TeX for use with Unicode sources
i xetex-itrans: Itrans input maps for use with XeLaTeX
i xetex-pstricks: Running PSTricks under XeTeX
i xetex-tibetan: XeTeX input maps for Unicode Tibetan
i xetex.universal-darwin: universal-darwin files of xetex
i xetexconfig: crop.cfg for XeLaTeX
i xetexfontinfo: Report font features in XeTeX
i xetexko: Typeset Korean with Xe(La)TeX
i xevlna: Insert non-breakable spaces using XeTeX
i xfrac: Split-level fractions
i xkeyval: Extension of the keyval package
i xltxtra: "Extras" for LaTeX users of XeTeX
i xpatch: Extending etoolbox patching commands
i xstring: String manipulation for (La)TeX
i xunicode: Generate Unicode characters from accented glyphs
i zapfchan: URW 'Base 35' font pack for LaTeX
i zapfding: URW 'Base 35' font pack for LaTeX
i zbmath-review-template: Template for a zbMATH Open review
